########################################################
##....................................................##
##....................................................##
##....................................................##
##....................................................##
##....................................................##
##....................................................##
##....................................................##
##....................................................##
##....................................................##
##......................####..........................##
##....................######>.........................##
##.................#########>.........................##
##..............############>.........................##
##S..x.......G###############^^.......................##
########################################################
########################################################
########################################################